111111111111111111111111
100000000000000000000001
100000000000000000000001
100000000000000000000001
100000222220000300300301
100000200020000000000001
100000200020000300300301
100000200020000000000001
100000220220000300300301
100000000000000000000001
100000000000000000000001
100000000000000000000001
100000000000000000000001
100000000000000000000001
100000000000000000000001
100000000000000000000001
144444440000000000000001
140400004000000000000001
140000050400000000000001
140400004000000000000001
140444444000000000000001
140000000000000000000001
144444440000000000000001
111111111111111111111111